AAE	AAE	AAE全球专递
ANE	ANE	安能物流
ARAMEX	ARAMEX	Aramex
AT	AT	奥地利邮政
BALUNZHI	BALUNZHI	巴伦支快递
BEL	BEL	比利时邮政
BFDF	BFDF	百福东方
BHT	BHT	BHT快递
BKWL	BKWL	宝凯物流
BQXHM	BQXHM	北青小红帽
BR	BR	巴西邮政
BSWL	BSWL	邦送物流
CA	CA	加拿大邮政
CITY100	CITY100	城市100
COE	COE	COE东方快递
CSCY	CSCY	长沙创一
D4PX	D4PX	递四方速递
DBL	DBL	德邦
DHL_C	DHL_C	DHL(中国件)
DHL_DE	DHL_DE	DHL(德国件)
DHL_GLB	DHL_GLB	DHL全球
DHL_USA	DHL_USA	DHL(美国)
DK	DK	丹麦邮政
DPEX	DPEX	DPEX
DSWL	DSWL	D速物流
DTWL	DTWL	大田物流
EMS	EMS	EMS国内
EMSGJ	EMSGJ	EMS国际
FAST	FAST	快捷速递
FEDEX_C	FEDEX_C	FedEx联邦快递(中国件)
FKD	FKD	飞康达
FKRFD	FKRFD	凡客如风达
GHX	GHX	挂号信
GJYZ	GJYZ	国际邮政包裹
GSD	GSD	共速达
GTO	GTO	国通快递
GTSD	GTSD	高铁速递
HHTT	HHTT	天天快递
HOAU	HOAU	天地华宇
hq568	hq568	华强物流
HTKY	HTKY	百世汇通
HXLWL	HXLWL	华夏龙物流
HYLSD	HYLSD	好来运快递
IE	IE	爱尔兰邮政
JD	JD	京东快递
JGSD	JGSD	京广速递
JJKY	JJKY	佳吉快运
JLDT	JLDT	嘉里大通
JP	JP	日本邮政
JTKD	JTKD	捷特快递
JXD	JXD	急先达
JYKD	JYKD	晋越快递
JYM	JYM	加运美
JYWL	JYWL	佳怡物流
LB	LB	龙邦快递
LHTEX	LHTEX	联昊通速递
NEDA	NEDA	能达速递
NL	NL	荷兰邮政
ONTRAC	ONTRAC	ONTRAC
QFKD	QFKD	全峰快递
QRT	QRT	全日通快递
RDSE	RDSE	瑞典邮政
SDWL	SDWL	上大物流
SF	SF	顺丰快递
SFWL	SFWL	盛丰物流
SHWL	SHWL	盛辉物流
ST	ST	速通物流
STO	STO	申通快递
STSD	STSD	三态速递
SURE	SURE	速尔快递
SWCH	SWCH	瑞士邮政
TSSTO	TSSTO	唐山申通
UAPEX	UAPEX	全一快递
UC	UC	优速快递
UPS	UPS	UPS
USPS	USPS	USPS美国邮政
XFEX	XFEX	信丰快递
XYT	XYT	希优特
YADEX	YADEX	源安达快递
YAMA	YAMA	日本大和运输(Yamato)
YD	YD	韵达快递
YFEX	YFEX	越丰物流
YFHEX	YFHEX	原飞航物流
YJSD	YJSD	银捷速递
YTO	YTO	圆通速递
YZPY	YZPY	邮政平邮/小包
ZENY	ZENY	增益快递
ZJS	ZJS	宅急送
ZMKM	ZMKM	芝麻开门
ZTE	ZTE	众通快递
ZTKY	ZTKY	中铁快运
ZTO	ZTO	中通速递
ZTWL	ZTWL	中铁物流
ZY_AG	ZY_AG	爱购转运
ZY_AOZ	ZY_AOZ	爱欧洲
ZY_AUSE	ZY_AUSE	澳世速递
ZY_AXO	ZY_AXO	AXO
ZY_AZY	ZY_AZY	澳转运
ZY_BDA	ZY_BDA	八达网
ZY_BEE	ZY_BEE	蜜蜂速递
ZY_BH	ZY_BH	贝海速递
ZY_BL	ZY_BL	百利快递
ZY_BM	ZY_BM	斑马物流
ZY_BOZ	ZY_BOZ	败欧洲
ZY_BT	ZY_BT	百通物流
ZY_BYECO	ZY_BYECO	贝易购
ZY_CM	ZY_CM	策马转运
ZY_CTM	ZY_CTM	赤兔马转运
ZY_CUL	ZY_CUL	CUL中美速递
ZY_DGHT	ZY_DGHT	德国海淘之家
ZY_DYW	ZY_DYW	德运网
ZY_EFS	ZY_EFS	EFS POST
ZY_ETD	ZY_ETD	ETD
ZY_FD	ZY_FD	飞碟快递
ZY_FG	ZY_FG	飞鸽快递
ZY_FLSD	ZY_FLSD	风雷速递
ZY_FX	ZY_FX	风行快递
ZY_FXSD	ZY_FXSD	风行速递
ZY_FY	ZY_FY	飞洋快递
ZY_HC	ZY_HC	皓晨快递
ZY_HCYD	ZY_HCYD	皓晨优递
ZY_HDB	ZY_HDB	海带宝
ZY_HFMZ	ZY_HFMZ	汇丰美中速递
ZY_HJSD	ZY_HJSD	豪杰速递
ZY_HMKD	ZY_HMKD	华美快递
ZY_HTAO	ZY_HTAO	360hitao转运
ZY_HTCUN	ZY_HTCUN	海淘村
ZY_HTKE	ZY_HTKE	365海淘客
ZY_HTONG	ZY_HTONG	华通快运
ZY_HXKD	ZY_HXKD	海星桥快递
ZY_HXSY	ZY_HXSY	华兴速运
ZY_HYSD	ZY_HYSD	海悦速递
ZY_IHERB	ZY_IHERB	LogisticsY
ZY_JA	ZY_JA	君安快递
ZY_JD	ZY_JD	时代转运
ZY_JDKD	ZY_JDKD	骏达快递
ZY_JDZY	ZY_JDZY	骏达转运
ZY_JH	ZY_JH	久禾快递
ZY_JHT	ZY_JHT	金海淘
ZY_LBZY	ZY_LBZY	联邦转运FedRoad
ZY_LPZ	ZY_LPZ	领跑者快递
ZY_LX	ZY_LX	龙象快递
ZY_LZWL	ZY_LZWL	量子物流
ZY_MBZY	ZY_MBZY	明邦转运
ZY_MGZY	ZY_MGZY	美国转运
ZY_MJ	ZY_MJ	美嘉快递
ZY_MST	ZY_MST	美速通
ZY_MXZY	ZY_MXZY	美西转运
ZY_MZ	ZY_MZ	168 美中快递
ZY_OEJ	ZY_OEJ	欧e捷
ZY_OZF	ZY_OZF	欧洲疯
ZY_OZGO	ZY_OZGO	欧洲GO
ZY_QMT	ZY_QMT	全美通
ZY_QQEX	ZY_QQEX	QQ-EX
ZY_RDGJ	ZY_RDGJ	润东国际快线
ZY_RT	ZY_RT	瑞天快递
ZY_RTSD	ZY_RTSD	瑞天速递
ZY_SCS	ZY_SCS	SCS国际物流
ZY_SDKD	ZY_SDKD	速达快递
ZY_SFZY	ZY_SFZY	四方转运
ZY_SOHO	ZY_SOHO	SOHO苏豪国际
ZY_SONIC	ZY_SONIC	Sonic-Ex速递
ZY_ST	ZY_ST	上腾快递
ZY_TCM	ZY_TCM	通诚美中快递
ZY_TJ	ZY_TJ	天际快递
ZY_TM	ZY_TM	天马转运
ZY_TN	ZY_TN	滕牛快递
ZY_TPAK	ZY_TPAK	TrakPak
ZY_TPY	ZY_TPY	太平洋快递
ZY_TSZ	ZY_TSZ	唐三藏转运
ZY_TTHT	ZY_TTHT	天天海淘
ZY_TWC	ZY_TWC	TWC转运世界
ZY_TX	ZY_TX	同心快递
ZY_TY	ZY_TY	天翼快递
ZY_TZH	ZY_TZH	同舟快递
ZY_UCS	ZY_UCS	UCS合众快递
ZY_WDCS	ZY_WDCS	文达国际DCS
ZY_XC	ZY_XC	星辰快递
ZY_XDKD	ZY_XDKD	迅达快递
ZY_XDSY	ZY_XDSY	信达速运
ZY_XF	ZY_XF	先锋快递
ZY_XGX	ZY_XGX	新干线快递
ZY_XIYJ	ZY_XIYJ	西邮寄
ZY_XJ	ZY_XJ	信捷转运
ZY_YGKD	ZY_YGKD	优购快递
ZY_YJSD	ZY_YJSD	友家速递(UCS)
ZY_YPW	ZY_YPW	云畔网
ZY_YQ	ZY_YQ	云骑快递
ZY_YQWL	ZY_YQWL	一柒物流
ZY_YSSD	ZY_YSSD	优晟速递
ZY_YSW	ZY_YSW	易送网
ZY_YTUSA	ZY_YTUSA	运淘美国
ZY_ZCSD	ZY_ZCSD	至诚速递
ZYWL	ZYWL	中邮物流
